угонка=угон автомобиля
ай-яй-яй=огорчение
ан*ша=ангина
ебобо=боже мой
фуфлыжниками=пустыми людьми
по чесноку=честно
по понятиям=по правилам
капетан=капитан
омерика=америка
кринж=неловкость
йо..анный=йома́нный
смылся=убежал
бухают=пьют алкоголь
зумеры=молодое поколение
олды=старшее поколение
токарь=видеоблогер
твичек=девушка с twitch
паблик=паблик (публичная страница)
респект=уважение
вин=победа
хайп=ажиотаж
лайфхак=совет по улучшению жизни
трэш=белиберда
топ=лучший
мем=интернет-шутка
флексить=хвастаться
хейт=негатив
рип=печаль
ржунимагу=смеюсь
ля=выражение удивления
че=что
фул=полный
сраш=критика
хайповое=модное
прикол=шутка
падонки=сленг, жаргон
сериал=фильм
мажор=богатый человек
лошара=неудачник
лузер=проигравший
каво=вопрос
го=предложение действовать
френдзону=общщение без романтических отношений
шансон=русская романтическая музыка
жиза=жизнь
диджей=музыкант, ведущий вечеринку
флекс=демонстрация успеха
фан=поддержка
хипстеры=молодые люди, следящие за трендами
контент=контент (материал в интернете)
хейтер=критикующий человек
майнкрафт=компьютерная игра
мемасики=шутки
понтоваться=хвастаться
френд=друг
месседж=сообщение
лайк=понравилось
дизлайк=не понравилось
камент=комментарий
вижуал=визуальное оформление
стайл=стиль
саунд=звуковое оформление
пост=публикация
инфлюенсер=влиятельный пользователь сети
троллинг=намеренная провокация
флешмоб=массовое мероприятие
ток-шоу=телепередача
вирусный=распространяемый в сети
влог=видео о повседневной жизни
подписчики=читатели/зрители
репост=перепост
реакция=ответ на событие
реклама=рекламный контент
канал=ютуб-канал
юмористическое=смешное
мультяшка=мультфильм
кино=фильм
туповато=глупо
забив=забивать
залипнуть=провести много времени
нарезка=компиляция видео
фулл хаус=полный зал
реквест=запрос
скилл=навык
мемчик=шутка
банальный=обыденный
милота=миловидность
флуд=бесполезные сообщения
спам=нежелательные сообщения
луркать=читать, не участвуя
флудилка=чат
пингвин=пользователь linux
варезники=люди, распространяющие пиратский контент
крайне негативно=очень плохо
френдзоны=общение без любви
мажорство=богатство
грустняк=грусть
нюдс=фотографии обнажённого тела
сиськи=грудь
жопа=задний проход
член=пенис
минет=оральный секс
ебля=секс
наркота=наркотики
косяк=сигарета с наркотиком
травка=марихуана
наркоман=человек, зависимый от наркотиков
наркозависимость=зависимость от наркотиков
шприц=инструмент для инъекций
дрочить=мастурбировать
порнуха=порнография
бабки=деньги
бабосы=деньги
шмотки=одежда
шмот=одежда
тёлки=девушки
чувак=мужчина
пацан=мужчина
мужик=мужчина
братюни=друзья
кореш=друг
деваха=девушка
красотка=привлекательная девушка
милка=милая девушка
крутяк=отличный человек
лох=обманутый человек
дурачок=глупый человек
дурак=глупец
тупой=неумный
туповат=не особо умный
балбес=глупец
ботаник=ученик, увлекающийся учебой
ботан=ученик, увлекающийся учебой
козёл=мужчина
козлина=грубая женщина
козёл отпущения=виноватый человек
коза=женщина
козочка=женщина
козлище=мужчина
козявка=женщина
козявочка=женщина
козявки=женщины
козёлки=мужчины
козлишки=мужчины
козявочки=женщины
козявушка=женщина
козявашка=женщина
козявулька=женщина
